%%%%%%%
%     %
% %%% %
% %.  %
% %%% %
%P    %
%%%%%%%
